A furious battle for 4 players~
4 17 80
~~~~~~~~~~~~~~~~~~~~~~~~.........~~~~~~~~~~~~~~~~~~~~~~~~~~~~~~~~~~~~~~~~~~~~~~~
~~~~~~~~~~~~~~~~~~~....c.....~~~~~~~~~~...~~~.......................~........~~~
~~~~~~~~~~~~~~~~~~~..........~~~~~~~~~...~~~........c.........................~~
~~~~~~~~~~~~~~~~~~~~~...c...~~~~~~~~~~...~~...................................~~
~~~~~~~~~~~~~~~~~~~~~~~...~~~~~~~~~~~~~~......................c..........c~~~~~~
~~~~~~~~~~~~~~~~~~~~~~~~.~~~~~~~~~~~~~~c.......c........................~~~~~~~~
~~~~~~~~~~~~~~~~~~~~~~~~~~~~~~~~~~~~~.................c...............~~~~~~~~~~
~~~~~~~~~~~~~~~~~~~~~~~~~~~~~~~~~~~~~~~...............................~~~~~~~~~~
~~~~~............~~..~~~~~~~~~~~~~....~~~.............................~~~~~~~~~~
~~~~~.....c......~..~~~~~~~~~~~~~~...~~~~~~~~~~~~~~~~~~~................c~~~~~~~
~~~~~c............~~~~~~~~~~~~~~~~................~..~~~~........c........~~~~~~
~~~~~~~~~~..c....c~~~~~~~~~~~~~~..........c..........~~~~~c...............~~~~~~
~~~~~~~~~~~~.......~~~~~~~~~~~~~.....c...............~~~~~~~~..~~~~~~....~~~~~~~
~~~~~~~~~~~~~~~~....~~~~~~~~~~~~~~.~~~~~.........c~~~~~~~~~~~.~~~~~~....~~~~~~~~
~~~~~~~~~~~~~~~~~~~.~~~~~~~~~~~~~~~~~~~~..........~~~~~~~~~~~~~~~~~~~.~~~~~~~~~~
~~~~~~~~~~~~~~~~~~~~~~~~~~~~~~~~~~~~~~~~~~c......~~~~~~~~~~~~~~~~~~~~~~~~~~~~~~~
~~~~~~~~~~~~~~~~~~~~~~~~~~~~~~~~~~~~~~~~~~~~...~~~~~~~~~~~~~~~~~~~~~~~~~~~~~~~~~
