A simple map for two players.
2 32 64
~~~~~~~~~~~~~~~~~~~~~~~~~~~~~~~~...................~~~~~~~~~~~~~
~~~~...~~~~~~~~~~~~~~~~~~~~~~~~~~~~~~~...............~~~~~~~~~~~
.........~~~~~~~~~....~~~~~~~~~~~~~~~~~...~~.......~~~~~~~~~~~~~
......c....~~~~....~~~~~~~~~~~~~~~~~~....~~~...~~~~~~~~~~~~~~~~~
......~~........c..~~~~~~~~~~~~~~~.......c..........~~~~~~~~~~~~
~....~~~~~........~~~~~~~~~~~~~~~~~..........c....~~~~~~~~~~~~~~
~.....~~~~~.....~~~~~~~~~~~~~~~~~~~~.......^^....~~~~~~~~~~~~~~~
~~............~~~~~~~~~...~~~~~~~~~~~..c..^......~~~~~~~~~~~~~~~
~~.....c....~~~~~~~~~~c....~~~~~~~~~~~...^....~~~~~~~~~~~~~~~~~~
~~~~~~~~~~~~~~~~~~~~....c...~~~~~~~~~...............~~~~~~~~~~~~
~~~~~~~~~~~~~~~~~~~~~~.....~~~~~~~~~~......~~.......~~~~~~~~~~~~
~~~~~~~~~~~~~~~~~~~~~~~~~~~~~~~~~~~~~....c~~~~~.......~~~~~~~~~~
~~~....~~~~~~~~~~~~~~~~~~~~~~~~~~~~~~....~~~~~~~~~..c..~~~~~~~~~
~~..c...~~~~~~~~~........~~~~~~~~~~~~...~~~~~~~~~.....~~~~~~~~~~
.......~~~~~~c.........~~~~~~~~~~~~~~~~~~~~~......c.....~~~~~~~~
......~~~~~~~~...........~~~~~~~~~~~~~~~~~~~~~~...........~~~~~~
......~~~~~~~......c....~~~~~~~~~~~~~.....~~~~~~~~~~~~~~~~~~~~~~
~.c..~~~~~~~~~~..^^.....~~~~~~~~~~~~.......~~~~~~~~~~~~~~~~~~~~~
~~...~~~~~~~~.....^^.....~~~~~~~~~~.........~~~~~~~.......~~~~~~
~~...~~~~~~.....c..^^....~~~~~~~~~..........c~~~~~~~......~~~~~~
~~..~~~~~~............................^^^.....~~~~~~~..c..~~~~~~
~~.~~~~~~~.....~~~~~~~.................^^^^...~~~~~~~.....~~~~~~
~~~~~~~~~~~~~~~~~~~~~~~~.............c...^^^^..~~~~~~......~~~~~
~~~~~~~~~~~~~~~~~~~~~~~~~~~~~~~~.................~~~~........~~~
~~~~~~....~~......~~~~~~..~~~~~~~~...............~~~~...c....~~~
~~~~c..........~~~~~~~.c...~~~~~~~........c......~~~~~.....~~~~~
~~~~...........~~~~~.......~~~~~~~....~~~........~~~~~~~~~~~~~~~
~~~.......c.............c..~~~~~~~~....~~~........~~~~~~~~~~~~~~
~~~...c.....................~~~~~~~~.....~~~~~~~~~~~~~~~~~~~~~~~
~~~.........c....~~~~~~....c~~~~~~~~~~..~~~~~~~~~~~~~~~~~~~~~~~~
~~~~............c~~~~~~~~~~~~~~~~~~~~~~~~~~~~............c......
~~~~~~~......~~~~~~~~~~~~~~~~~~~~~~~~~~~~~~~...c................