A simple map for two players.
2 64 16
~~~~...~~~~~~~~~~~~~~~~~~~~~~~~~~~~~~~...............~~~~~~~~~~~
~~~~~....~~~~~~~~~....~~~~~~~~~~~~~~~~~............~~~~~~~~~~~~~
~~~...c....~~~~....~~~~~~~~~~~~~~~~~~..........~~~~~~~~~~~~~~~~~
~~~.............c..~~~~~~~~~~~~~~~.......c..........~~~~~~~~~~~~
~~................~~~~~~~~~~~~~~~~~..........c....~~~~~~~~~~~~~~
~...............~~~~~~~~~~~~~~~~~~~~.......^^....~~~~~~~~~~~~~~~
~~............~~~~~~~~~...~~~~~~~~~~~..c..^......~~~~~~~~~~~~~~~
~~.....c....~~~~~~~~~~c....~~~~~~~~~~~...^....~~~~~~~~~~~~~~~~~~
~~~~.....~~~~~~~~~~~....c...~~~~~~~~~...............~~~~~~~~~~~~
~~~~~...~~~~~~~~~~~~~~.....~~~~~~~~~~......~~.......~~~~~~~~~~~~
~~~~~~..~~~~~~~~~~~~~~~~~~~~~~~~~~~~~....c~~~~~.......~~~~~~~~~~
~~~....~~~~~~~~~~~~~~~~~~~~~~~~~~~~~~....~~~~~~~~~..c..~~~~~~~~~
~~..c...~~~~~~~~~........~~~~~~~~~~~~...~~~~~~~~~.....~~~~~~~~~~
~......~~~~~~c.........~~~~~~~~~~~~~~~~~~~~~......c.....~~~~~~~~
~.....~~~~~~~~...........~~~~~~~~~~~~~~~~~~~~~~...........~~~~~~
~~~...~~~~~~~......c....~~~~~~~~~~~~~.....~~~~~~~~~~~~~~~~~~~~~~
